  _____     ________  ____   ____  ________  _____       __    
 |_   _|   |_   __  ||_  _| |_  _||_   __  ||_   _|     /  |   
   | |       | |_ \_|  \ \   / /    | |_ \_|  | |       `| |   
   | |   _   |  _| _    \ \ / /     |  _| _   | |   _    | |   
  _| |__/ | _| |__/ |    \ ' /     _| |__/ | _| |__/ |  _| |_  
 |________||________|     \_/     |________||________| |_____|
