
   _____     ________  ____   ____  ________  _____       ______   
 |_   _|   |_   __  ||_  _| |_  _||_   __  ||_   _|     / ____ `. 
   | |       | |_ \_|  \ \   / /    | |_ \_|  | |       `'  __) | 
   | |   _   |  _| _    \ \ / /     |  _| _   | |   _   _  |__ '. 
  _| |__/ | _| |__/ |    \ ' /     _| |__/ | _| |__/ | | \____) | 
 |________||________|     \_/     |________||________|  \______.' 
 
