
   _____     ________  ____   ____  ________  _____      _    _    
 |_   _|   |_   __  ||_  _| |_  _||_   __  ||_   _|    | |  | |   
   | |       | |_ \_|  \ \   / /    | |_ \_|  | |      | |__| |_  
   | |   _   |  _| _    \ \ / /     |  _| _   | |   _  |____   _| 
  _| |__/ | _| |__/ |    \ ' /     _| |__/ | _| |__/ |     _| |_  
 |________||________|     \_/     |________||________|    |_____| 
                                                                  
