
   _____     ________  ____   ____  ________  _____      _______   
 |_   _|   |_   __  ||_  _| |_  _||_   __  ||_   _|    |  _____|  
   | |       | |_ \_|  \ \   / /    | |_ \_|  | |      | |____    
   | |   _   |  _| _    \ \ / /     |  _| _   | |   _  '_.____''. 
  _| |__/ | _| |__/ |    \ ' /     _| |__/ | _| |__/ | | \____) | 
 |________||________|     \_/     |________||________|  \______.' 
