
   _____     ________  ____   ____  ________  _____       _____   
 |_   _|   |_   __  ||_  _| |_  _||_   __  ||_   _|     / ___ `. 
   | |       | |_ \_|  \ \   / /    | |_ \_|  | |      |_/___) | 
   | |   _   |  _| _    \ \ / /     |  _| _   | |   _   .'____.' 
  _| |__/ | _| |__/ |    \ ' /     _| |__/ | _| |__/ | / /_____  
 |________||________|     \_/     |________||________| |_______| 
